1
32 39
0 0 0 0 0 0 0 0 0 0 1 2 3 3 3 3 3 3 3 3 3 3 3 3 3 3 3 3 3 4 5 6 6 6 6 6 6 6 6
0 0 0 0 0 0 0 0 0 0 1 7 8 8 8 8 8 8 8 8 8 8 8 8 8 8 8 8 8 4 5 6 6 6 6 6 6 6 6
0 0 0 0 0 0 0 0 0 0 1 2 3 3 3 3 3 3 3 3 3 3 3 3 3 3 3 3 3 4 5 6 6 6 6 6 6 6 6
0 0 0 0 0 0 0 0 0 0 1 9 8 8 8 8 8 8 8 8 8 8 8 8 8 8 8 8 8 4 5 6 6 6 6 6 6 6 6
0 0 0 0 0 0 0 0 0 0 1 9 3 3 3 3 3 3 3 3 3 3 3 3 3 3 3 3 3 4 5 6 6 6 6 6 6 6 6
0 0 0 0 0 0 0 0 0 0 1 10 8 8 8 8 8 8 8 8 8 8 8 8 8 8 8 8 8 4 5 6 6 6 6 6 6 6 6
0 0 0 0 0 0 0 0 0 0 1 9 3 3 3 3 3 3 3 3 3 3 3 3 3 3 3 3 3 4 5 6 6 6 6 6 6 6 6
0 0 0 0 0 0 0 0 0 0 1 9 3 3 3 3 3 3 3 11 12 13 3 3 3 3 3 3 3 14 5 6 6 6 6 6 6 6 6
0 0 0 0 0 0 0 0 0 0 1 10 3 15 15 15 15 15 3 16 17 18 3 19 15 15 15 15 3 20 5 6 6 6 6 6 6 6 6
0 0 0 0 0 0 0 0 0 0 1 21 22 22 22 22 22 22 22 23 24 25 22 22 22 22 22 22 22 26 5 6 6 6 6 6 6 6 6
0 0 0 0 0 0 0 0 0 0 1 27 28 28 28 28 28 28 27 29 30 31 27 28 28 28 28 28 28 27 5 6 6 6 6 6 6 6 6
0 0 0 0 0 0 0 0 0 0 1 27 27 27 27 27 27 27 27 27 27 27 27 32 27 27 27 27 27 27 5 6 6 6 6 6 6 6 6
0 0 0 0 0 0 0 33 34 34 35 36 27 37 38 38 38 38 38 38 38 38 38 38 38 38 38 39 27 27 5 6 6 6 6 6 6 6 6
0 0 0 0 0 0 0 1 40 41 42 43 27 44 45 45 45 45 45 45 45 45 45 45 45 45 45 46 27 27 5 6 6 6 6 6 6 6 6
0 0 0 0 0 0 0 1 40 41 42 47 27 44 45 48 49 50 51 45 45 45 45 45 45 45 45 46 27 27 5 6 6 6 6 6 6 6 6
0 0 0 0 0 0 0 1 40 41 42 27 27 44 45 52 53 54 55 45 45 45 45 45 45 45 45 46 27 27 56 57 58 6 6 6 6 6 6
0 0 0 0 0 0 0 1 40 41 42 27 27 44 45 59 60 61 62 45 45 45 45 45 45 45 45 46 27 27 63 64 5 6 6 6 6 6 6
0 0 0 0 0 0 0 1 65 66 67 27 27 44 45 68 45 45 69 45 45 45 45 45 45 45 45 46 27 27 70 71 5 6 6 6 6 6 6
0 0 0 0 0 0 0 1 72 73 27 27 27 44 45 45 45 45 45 45 45 45 45 45 45 45 45 46 27 27 70 71 5 6 6 6 6 6 6
0 0 0 0 0 0 0 1 74 75 27 27 27 44 45 76 77 78 79 45 45 76 77 78 79 45 45 46 27 27 70 71 5 6 6 6 6 6 6
0 0 0 0 0 0 0 80 81 81 82 27 27 44 45 83 84 85 86 45 45 83 84 85 86 45 45 46 27 27 87 88 5 6 6 6 6 6 6
0 0 0 0 0 0 0 0 0 0 1 27 27 44 45 89 90 91 92 45 45 89 90 91 92 45 45 46 27 27 72 73 5 6 6 6 6 6 6
0 0 0 0 0 0 0 0 0 0 1 36 27 44 45 93 45 45 94 45 45 93 45 45 94 45 45 46 27 27 95 96 5 6 6 6 6 6 6
0 0 0 0 0 0 0 0 0 0 1 43 27 97 98 98 98 98 98 98 98 98 98 98 98 98 98 99 27 27 74 75 5 6 6 6 6 6 6
0 0 0 0 0 0 0 0 0 0 1 47 27 27 27 27 27 27 27 27 27 27 27 27 27 27 27 27 27 27 100 101 102 6 6 6 6 6 6
34 34 34 34 34 34 34 34 34 34 35 27 27 27 27 27 27 27 27 27 27 27 27 27 27 27 27 27 27 27 5 6 6 6 6 6 6 6 6
103 103 103 103 103 103 103 103 103 103 42 104 105 106 106 105 106 106 107 107 107 107 107 106 106 105 106 106 105 108 5 6 6 6 6 6 6 6 6
103 41 103 41 103 41 103 41 103 41 42 109 110 111 111 110 111 111 112 112 112 112 112 111 111 110 111 111 110 113 114 115 115 115 115 115 115 115 115
103 41 103 41 103 41 103 41 103 41 42 116 117 117 117 117 117 118 119 119 119 119 119 120 121 121 121 121 121 122 63 123 123 123 123 123 123 123 123
103 103 103 103 103 103 103 103 103 103 42 116 117 117 117 117 117 118 119 119 119 119 119 120 121 121 121 121 121 122 70 124 125 124 125 124 125 124 125
103 103 103 103 103 103 103 103 103 103 42 116 117 117 117 117 117 118 119 119 119 119 119 120 121 121 121 121 121 122 70 125 125 125 125 125 125 125 125
66 66 66 66 66 66 66 66 66 66 67 116 117 117 117 117 117 118 119 119 119 119 119 120 121 121 121 121 121 122 70 124 125 124 125 124 125 124 125
END_MAP
1 1 1 1 1 1 1 1 1 1 1 1 1 1 1 1 1 1 1 1 1 1 1 1 1 1 1 1 1 1 1 1 1 1 1 1 1 1 1
1 1 1 1 1 1 1 1 1 1 1 1 1 1 1 1 1 1 1 1 1 1 1 1 1 1 1 1 1 1 1 1 1 1 1 1 1 1 1
1 1 1 1 1 1 1 1 1 1 1 1 1 1 1 1 1 1 1 1 1 1 1 1 1 1 1 1 1 1 1 1 1 1 1 1 1 1 1
1 1 1 1 1 1 1 1 1 1 1 1 1 1 1 1 1 1 1 1 1 1 1 1 1 1 1 1 1 1 1 1 1 1 1 1 1 1 1
1 1 1 1 1 1 1 1 1 1 1 1 1 1 1 1 1 1 1 1 1 1 1 1 1 1 1 1 1 1 1 1 1 1 1 1 1 1 1
1 1 1 1 1 1 1 1 1 1 1 1 1 1 1 1 1 1 1 1 1 1 1 1 1 1 1 1 1 1 1 1 1 1 1 1 1 1 1
1 1 1 1 1 1 1 1 1 1 1 1 1 1 1 1 1 1 1 1 1 1 1 1 1 1 1 1 1 1 1 1 1 1 1 1 1 1 1
1 1 1 1 1 1 1 1 1 1 1 1 1 1 1 1 1 1 1 1 1 1 1 1 1 1 1 1 1 1 1 1 1 1 1 1 1 1 1
1 1 1 1 1 1 1 1 1 1 1 1 1 1 1 1 1 1 1 1 1 1 1 1 1 1 1 1 1 1 1 1 1 1 1 1 1 1 1
1 1 1 1 1 1 1 1 1 1 1 1 1 1 1 1 1 1 1 1 2 1 1 1 1 1 1 1 1 1 1 1 1 1 1 1 1 1 1
1 1 1 1 1 1 1 1 1 1 1 0 1 1 1 1 1 1 0 0 0 0 0 1 1 1 1 1 1 0 1 1 1 1 1 1 1 1 1
1 1 1 1 1 1 1 1 1 1 1 0 0 0 0 0 0 0 0 0 0 0 0 3 0 0 0 0 0 0 1 1 1 1 1 1 1 1 1
1 1 1 1 1 1 1 1 1 1 1 1 0 0 0 0 0 0 0 0 0 0 0 0 0 0 0 0 0 0 1 1 1 1 1 1 1 1 1
1 1 1 1 1 1 1 1 1 1 1 1 0 0 0 0 0 0 0 0 0 0 0 0 0 0 0 0 0 0 1 1 1 1 1 1 1 1 1
1 1 1 1 1 1 1 1 1 1 1 1 0 0 0 1 1 1 1 0 0 0 0 0 0 0 0 0 0 0 1 1 1 1 1 1 1 1 1
1 1 1 1 1 1 1 1 1 1 1 0 0 0 0 1 1 1 1 0 0 0 0 0 0 0 0 0 0 0 1 1 1 1 1 1 1 1 1
1 1 1 1 1 1 1 1 1 1 1 0 0 0 0 1 1 1 1 0 0 0 0 0 0 0 0 0 0 0 1 1 1 1 1 1 1 1 1
1 1 1 1 1 1 1 1 1 1 1 0 0 0 0 0 0 0 0 0 0 0 0 0 0 0 0 0 0 0 1 1 1 1 1 1 1 1 1
1 1 1 1 1 1 1 1 1 0 0 0 0 0 0 0 0 0 0 0 0 0 0 0 0 0 0 0 0 0 1 1 1 1 1 1 1 1 1
1 1 1 1 1 1 1 1 1 0 0 0 0 0 0 1 1 1 1 0 0 1 1 1 1 0 0 0 0 0 1 1 1 1 1 1 1 1 1
1 1 1 1 1 1 1 1 1 1 1 0 0 0 0 1 1 1 1 0 0 1 1 1 1 0 0 0 0 0 1 1 1 1 1 1 1 1 1
1 1 1 1 1 1 1 1 1 1 1 0 0 0 0 1 1 1 1 0 0 1 1 1 1 0 0 0 0 0 0 2 1 1 1 1 1 1 1
1 1 1 1 1 1 1 1 1 1 1 1 0 0 0 0 0 0 0 0 0 0 0 0 0 0 0 0 0 0 0 2 1 1 1 1 1 1 1
1 1 1 1 1 1 1 1 1 1 1 1 0 0 0 0 0 0 0 0 0 0 0 0 0 0 0 0 0 0 0 2 1 1 1 1 1 1 1
1 1 1 1 1 1 1 1 1 1 1 1 0 0 0 0 0 0 0 0 0 0 0 0 0 0 0 0 0 0 1 1 1 1 1 1 1 1 1
1 1 1 1 1 1 1 1 1 1 1 0 0 0 0 0 0 0 0 0 0 0 0 0 0 0 0 0 0 0 1 1 1 1 1 1 1 1 1
1 1 1 1 1 1 1 1 1 1 1 1 1 1 1 1 1 1 1 1 1 1 1 1 1 1 1 1 1 1 1 1 1 1 1 1 1 1 1
1 1 1 1 1 1 1 1 1 1 1 1 1 1 1 1 1 1 1 1 1 1 1 1 1 1 1 1 1 1 1 1 1 1 1 1 1 1 1
1 1 1 1 1 1 1 1 1 1 1 1 1 1 1 1 1 1 1 1 1 1 1 1 1 1 1 1 1 1 1 1 1 1 1 1 1 1 1
1 1 1 1 1 1 1 1 1 1 1 1 1 1 1 1 1 1 1 1 1 1 1 1 1 1 1 1 1 1 1 1 1 1 1 1 1 1 1
1 1 1 1 1 1 1 1 1 1 1 1 1 1 1 1 1 1 1 1 1 1 1 1 1 1 1 1 1 1 1 1 1 1 1 1 1 1 1
1 1 1 1 1 1 1 1 1 1 1 1 1 1 1 1 1 1 1 1 1 1 1 1 1 1 1 1 1 1 1 1 1 1 1 1 1 1 1
END_COLLISION_MAP
MAP_NEXT_NPC
10 18 1
res/npcsprite/npcSprite4.png
Sorry kid. The road to the rest of VNU is closed for now.
Your access is limited to just the G2 and E3 buildings.
NPC_DIALOGUE_END
MAP_NEXT_NPC
10 19 1
res/npcsprite/npcSprite7.png
Do spare a thought for the young 3 developers of this game.
Discrete Math, Calculus and General Physics swallowed them whole!
NPC_DIALOGUE_END
MAP_NEXT_NPC
28 16 1
res/npcsprite/npcSprite11.png
This building here used to be the University of Business and Economics.
But it has ceased to exist 30 years ago after AI fully and utterly obsoleted the business majors.
Now all the aspiring business students are relegated to battling on cryptocurrency and NFTs markets.
Powered by engineering students of course.
NPC_DIALOGUE_END
NPC_DATA_STOP
WARP_NEXT_TILE
31 21 0 7 21
WARP_NEXT_TILE
31 22 0 7 22
WARP_NEXT_TILE
31 23 0 7 23
WARP_NEXT_TILE
20 9 2 29 17
WARP_DATA_STOP
INTER_NEXT_TILE
23 11
E3 Building.
Preparation zone, nerds' lobby and the final lingering academical aspect of the university.
INTER_DIALOGUE_END
INTER_DATA_STOP