38 55
0 0 0 0 0 0 0 0 0 0 0 0 0 0 0 0 0 0 0 0 0 0 0 0 0 0 0 0 0 0 0 0 0 0 0 0 0 0 0 0 0 0 0 0 0 0 0 0 0 0 0 0 0 0 0
0 0 0 0 0 0 0 0 0 0 0 0 0 0 0 0 0 0 0 0 0 0 0 0 0 0 0 0 0 0 0 0 0 0 0 0 0 0 0 0 0 0 0 0 0 0 0 0 0 0 0 0 0 0 0
1 1 1 1 1 1 1 1 1 1 1 1 1 1 1 1 1 1 1 1 1 1 1 1 1 1 1 1 1 1 1 1 1 1 1 1 1 1 1 1 1 1 1 1 1 1 1 1 1 1 1 0 0 0 0
2 2 2 2 2 2 2 2 2 2 2 2 2 2 2 2 2 2 2 2 2 2 2 2 2 2 2 2 2 2 2 2 2 2 2 2 2 2 2 2 2 2 2 2 2 2 2 2 2 2 2 3 0 0 0
4 4 4 4 4 4 4 4 5 6 4 4 4 5 6 4 4 4 4 4 4 4 4 4 4 4 4 4 4 4 4 4 4 4 4 4 4 4 4 4 4 4 4 4 4 4 4 4 4 5 2 3 0 0 0
2 2 2 2 2 2 2 2 7 2 2 8 2 2 9 2 10 11 12 10 11 12 2 2 2 2 2 2 13 14 14 14 14 14 14 14 14 15 2 2 2 2 2 2 2 16 17 16 17 7 2 3 0 0 0
18 18 18 18 18 18 19 20 7 2 21 22 23 2 9 10 11 12 10 11 12 24 25 25 25 25 25 25 26 27 27 27 27 27 27 27 27 28 25 25 25 25 25 25 29 30 31 30 31 7 2 3 0 0 0
32 32 32 32 32 32 33 34 7 2 3 0 35 2 9 10 11 12 10 11 12 36 37 38 39 39 39 39 40 41 41 41 41 41 41 41 41 42 39 39 39 39 43 37 44 16 17 16 17 7 2 3 0 0 0
32 32 32 32 32 32 32 45 7 2 3 0 35 2 9 10 11 12 10 11 12 36 2 46 47 47 47 47 48 49 49 49 49 49 49 49 49 50 47 47 47 47 51 2 44 30 31 30 31 7 2 3 0 0 0
32 32 32 32 32 32 32 45 7 2 3 0 35 2 9 2 2 2 10 11 12 36 37 46 47 47 47 47 47 47 47 47 47 47 47 47 47 47 47 47 47 47 51 37 44 16 17 16 17 7 2 3 0 0 0
32 32 32 32 32 32 32 45 7 2 3 0 35 2 9 2 2 2 10 11 12 36 2 46 47 47 47 47 47 47 47 47 47 47 47 47 47 47 47 47 47 47 51 2 44 30 31 30 31 7 2 3 0 0 0
32 32 32 32 32 32 32 45 7 2 3 0 35 2 52 4 5 2 10 11 12 36 37 46 47 47 47 47 47 47 47 47 47 47 47 47 47 47 47 47 47 47 51 37 44 16 17 16 17 7 2 3 0 0 0
32 32 32 32 32 32 32 45 7 2 3 0 35 2 2 2 2 2 10 11 12 36 2 53 54 54 54 54 54 54 54 54 54 54 54 54 54 54 54 54 54 54 55 2 44 30 31 30 31 7 2 3 0 0 0
32 32 32 32 32 32 32 45 7 2 3 0 35 2 6 4 5 2 10 11 12 36 37 56 57 56 57 56 57 56 57 56 57 56 57 56 57 56 57 56 57 56 57 37 44 16 17 16 17 7 2 3 0 0 0
32 32 32 32 32 32 32 45 7 2 3 0 35 2 9 10 11 12 10 11 12 36 2 58 59 59 59 59 59 59 59 59 59 59 59 59 59 59 59 59 59 59 60 2 44 30 31 30 31 7 2 3 0 0 0
32 32 32 32 32 32 32 45 7 2 3 0 35 2 9 10 11 12 10 11 12 36 37 53 54 54 54 54 54 54 54 61 62 62 63 54 54 54 54 54 54 54 55 37 44 16 17 16 17 7 2 3 0 0 0
32 32 32 32 32 32 32 45 7 2 3 0 35 2 9 2 2 16 17 16 17 36 2 56 57 56 57 56 57 56 57 64 65 65 66 56 57 56 57 56 57 56 57 2 44 30 31 30 31 7 2 3 0 0 0
32 32 32 32 32 32 67 68 7 2 3 0 35 2 9 2 2 30 31 30 31 36 37 58 59 59 59 59 59 59 59 69 70 70 71 59 59 59 59 59 59 59 60 37 44 16 17 16 17 7 2 3 0 0 0
32 32 32 32 32 45 72 73 7 2 3 0 35 2 9 2 2 16 17 16 17 74 75 75 75 75 75 75 76 77 77 77 77 77 77 77 77 78 75 75 75 75 75 75 79 30 31 30 31 7 2 3 0 0 0
32 32 32 32 32 45 72 73 80 2 3 0 35 2 52 4 5 30 31 30 31 2 2 10 11 12 2 2 81 77 77 77 77 77 77 77 77 82 2 2 83 84 85 2 2 2 2 2 2 7 2 3 0 0 0
32 32 32 32 32 45 86 87 2 2 3 0 35 2 2 2 2 2 2 2 2 2 2 2 2 2 2 2 2 2 2 2 2 2 2 2 2 88 2 2 89 90 91 2 2 2 2 2 2 7 2 3 0 0 0
32 32 32 32 32 45 92 93 22 22 0 0 0 22 22 22 22 22 22 22 22 22 22 22 22 22 22 22 22 22 22 22 22 22 22 22 22 22 22 22 22 22 22 22 22 22 22 23 2 7 2 3 0 0 0
32 32 32 32 32 45 94 95 0 0 0 0 0 0 0 0 0 0 0 0 0 0 0 0 0 0 0 0 0 0 0 0 0 0 0 0 0 0 0 0 0 0 0 0 0 0 0 35 8 7 2 3 0 0 0
32 32 32 32 32 45 96 97 1 1 0 0 0 1 1 1 1 1 1 1 1 1 1 1 1 1 1 1 1 1 1 1 1 1 1 1 1 1 1 1 1 1 1 1 1 1 1 98 2 7 2 3 0 0 0
32 32 32 32 32 32 18 99 2 2 3 0 35 2 2 2 2 2 2 2 2 2 2 2 2 2 2 2 2 2 2 2 2 2 2 2 2 2 2 2 2 2 2 2 2 2 2 2 2 7 2 3 0 0 0
32 32 32 32 32 32 32 45 5 2 3 0 35 2 6 4 4 4 4 4 4 4 4 4 4 4 4 4 4 4 4 4 4 4 4 4 4 4 4 4 4 4 4 4 4 4 4 4 4 80 2 3 0 0 0
32 32 32 32 32 32 32 45 7 2 3 0 35 2 9 2 2 2 2 2 2 2 2 2 2 2 2 2 2 2 2 2 2 2 2 2 2 2 2 2 2 2 2 2 2 2 2 2 2 7 2 3 0 0 0
32 32 32 32 32 32 32 45 7 2 3 0 35 2 9 2 100 101 102 103 104 100 101 102 103 104 100 101 102 103 104 100 101 102 103 104 100 101 102 103 104 100 101 102 103 104 100 101 2 7 2 3 0 0 0
32 32 32 32 32 32 32 45 7 2 3 0 35 2 9 2 105 106 107 108 109 105 106 107 108 109 105 106 107 108 109 105 106 107 108 109 105 106 107 108 109 105 106 107 108 109 105 106 2 7 2 3 0 0 0
32 32 32 32 32 32 32 45 7 2 3 0 35 2 9 2 105 106 110 111 112 105 106 110 111 112 105 106 110 111 112 105 106 110 111 112 105 106 110 111 112 105 106 110 111 112 105 106 2 7 2 3 0 0 0
67 67 67 67 67 67 67 68 7 2 3 0 35 2 9 2 105 113 114 114 114 113 113 114 114 114 113 113 114 114 114 113 113 114 114 114 113 113 114 114 114 113 113 114 114 114 113 106 2 7 2 3 0 0 0
115 116 115 116 115 116 115 73 7 2 117 1 98 2 9 2 105 113 118 118 118 113 113 118 118 118 113 113 118 118 118 113 113 118 118 118 113 113 118 118 118 113 113 118 118 118 113 106 2 7 2 3 0 0 0
115 116 115 116 115 116 115 73 7 2 2 8 2 2 9 2 105 106 102 103 104 105 106 102 103 104 105 106 102 103 104 105 106 102 103 104 105 106 102 103 104 105 106 102 103 104 105 106 2 7 2 3 0 0 0
115 116 115 116 115 116 115 73 7 6 4 4 4 5 9 2 105 106 107 108 109 105 106 107 108 109 105 106 107 108 109 105 106 107 108 109 105 106 107 108 109 105 106 107 108 109 105 106 2 7 2 3 0 0 0
119 119 119 119 119 119 119 87 7 2 2 2 2 2 9 2 120 121 110 111 112 120 121 110 111 112 120 121 110 111 112 120 121 110 111 112 120 121 110 111 112 120 121 110 111 112 120 121 2 7 2 3 0 0 0
2 2 2 2 2 2 2 2 7 2 2 2 2 2 9 2 2 2 2 2 2 2 2 2 2 2 2 2 2 2 2 2 2 2 2 2 2 2 2 2 2 2 2 2 2 2 2 2 2 7 2 3 0 0 0
4 4 4 4 4 4 4 4 80 2 2 2 2 2 6 4 4 4 4 4 4 4 4 4 4 4 4 4 4 4 4 4 4 4 4 4 4 4 4 4 4 4 4 4 4 4 4 4 4 80 2 3 0 0 0
2 2 2 2 2 2 2 2 2 2 2 2 2 2 2 2 2 2 2 2 2 2 2 2 2 2 2 2 2 2 2 2 2 2 2 2 2 2 2 2 2 2 2 2 2 2 2 2 2 2 2 3 0 0 0
END_MAP
0 0 0 0 0 0 0 0 0 0 0 0 0 0 0 0 0 0 0 0 0 0 0 0 0 0 0 0 0 0 0 0 0 0 0 0 0 0 0 0 0 0 0 0 0 0 0 0 0 0 0 0 0 0 0
0 0 0 0 0 0 0 0 0 0 0 0 0 0 0 0 0 0 0 0 0 0 0 0 0 0 0 0 0 0 0 0 0 0 0 0 0 0 0 0 0 0 0 0 0 0 0 0 0 0 0 0 0 0 0
0 0 0 0 0 0 0 0 0 0 0 0 0 0 0 0 0 0 0 0 0 0 0 0 0 0 0 0 0 0 0 0 0 0 0 0 0 0 0 0 0 0 0 0 0 0 0 0 0 0 0 0 0 0 0
0 0 0 0 0 0 0 0 0 0 0 0 0 0 0 0 0 0 0 0 0 0 0 0 0 0 0 0 0 0 0 0 0 0 0 0 0 0 0 0 0 0 0 0 0 0 0 0 0 0 0 0 0 0 0
1 1 1 1 1 1 1 1 1 1 1 1 1 1 1 1 1 1 1 1 1 1 1 1 1 1 1 1 1 1 1 1 1 1 1 1 1 1 1 1 1 1 1 1 1 1 1 1 1 1 0 0 0 0 0
1 1 1 1 1 1 1 1 1 0 0 3 0 0 1 1 1 1 1 1 1 1 1 1 1 1 1 1 1 1 1 1 1 1 1 1 1 1 1 1 1 1 1 1 1 1 1 1 1 1 0 0 0 0 0
1 1 1 1 1 1 1 1 1 0 0 0 0 0 1 1 1 1 1 1 1 1 0 0 0 0 0 0 0 1 1 1 1 1 1 1 1 0 0 0 0 0 0 0 1 1 1 1 1 1 0 0 0 0 0
1 1 1 1 1 1 1 1 1 0 0 0 0 0 1 1 1 1 1 1 1 1 0 1 1 1 1 1 1 1 1 1 1 1 1 1 1 1 1 1 1 1 1 0 1 1 1 1 1 1 0 0 0 0 0
1 1 1 1 1 1 1 1 1 0 0 0 0 0 1 1 1 1 1 1 1 1 0 1 1 1 1 1 1 1 1 1 1 1 1 1 1 1 1 1 1 1 1 0 1 1 1 1 1 1 0 0 0 0 0
1 1 1 1 1 1 1 1 1 0 0 0 0 0 1 0 0 0 1 1 1 1 0 1 1 1 1 1 1 1 1 1 1 1 1 1 1 1 1 1 1 1 1 0 1 1 1 1 1 1 0 0 0 0 0
1 1 1 1 1 1 1 1 1 0 0 0 0 0 1 0 0 0 1 1 1 1 0 1 1 1 1 1 1 1 1 1 1 1 1 1 1 1 1 1 1 1 1 0 1 1 1 1 1 1 0 0 0 0 0
1 1 1 1 1 1 1 1 1 0 0 0 0 0 1 1 1 0 1 1 1 1 0 1 1 1 1 1 1 1 1 1 1 1 1 1 1 1 1 1 1 1 1 0 1 1 1 1 1 1 0 0 0 0 0
1 1 1 1 1 1 1 1 1 0 0 0 0 0 0 0 0 0 1 1 1 1 0 1 1 1 1 1 1 1 1 1 1 1 1 1 1 1 1 1 1 1 1 0 1 1 1 1 1 1 0 0 0 0 0
1 1 1 1 1 1 1 1 1 0 0 0 0 0 1 1 1 0 1 1 1 1 0 1 1 1 1 1 1 1 1 1 1 1 1 1 1 1 1 1 1 1 1 0 1 1 1 1 1 1 0 0 0 0 0
1 1 1 1 1 1 1 1 1 0 0 0 0 0 1 1 1 1 1 1 1 1 0 1 1 1 1 1 1 1 1 1 1 1 1 1 1 1 1 1 1 1 1 0 1 1 1 1 1 1 0 0 0 0 0
1 1 1 1 1 1 1 1 1 0 0 0 0 0 1 1 1 1 1 1 1 1 0 1 1 1 1 1 1 1 1 1 1 1 1 1 1 1 1 1 1 1 1 0 1 1 1 1 1 1 0 0 0 0 0
1 1 1 1 1 1 1 1 1 0 0 0 0 0 1 0 0 1 1 1 1 1 0 1 1 1 1 1 1 1 1 1 2 2 1 1 1 1 1 1 1 1 1 0 1 1 1 1 1 1 0 0 0 0 0
1 1 1 1 1 1 1 1 1 0 0 0 0 0 1 0 0 1 1 1 1 1 0 1 1 1 1 1 1 1 1 1 0 0 1 1 1 1 1 1 1 1 1 0 1 1 1 1 1 1 0 0 0 0 0
1 1 1 1 1 1 1 1 1 0 0 0 0 0 1 0 0 1 1 1 1 1 1 1 1 1 1 1 1 0 0 0 0 0 0 0 0 1 1 1 1 1 1 1 1 1 1 1 1 1 0 0 0 0 0
1 1 1 1 1 1 1 1 1 0 0 0 0 0 1 1 1 1 1 1 1 0 0 1 1 1 0 0 1 0 0 0 0 0 0 0 0 1 0 0 3 1 3 0 0 0 0 0 0 1 0 0 0 0 0
1 1 1 1 1 1 1 1 0 0 0 0 0 0 0 0 0 0 0 0 0 0 0 0 0 0 0 0 0 0 0 0 0 0 0 0 0 3 0 0 3 3 3 0 0 0 0 0 0 1 0 0 0 0 0
1 1 1 1 1 1 2 0 0 0 0 0 0 0 0 0 0 0 0 0 0 0 0 0 0 0 0 0 0 0 0 0 0 0 0 0 0 0 0 0 0 0 0 0 0 0 0 0 0 1 0 0 0 0 0
1 1 1 1 1 1 2 0 0 0 0 0 0 0 0 0 0 0 0 0 0 0 0 0 0 0 0 0 0 0 0 0 0 0 0 0 0 0 0 0 0 0 0 0 0 0 0 0 3 1 0 0 0 0 0
1 1 1 1 1 1 2 0 0 0 0 0 0 0 0 0 0 0 0 0 0 0 0 0 0 0 0 0 0 0 0 0 0 0 0 0 0 0 0 0 0 0 0 0 0 0 0 0 0 1 0 0 0 0 0
1 1 1 1 1 1 1 1 0 0 0 0 0 0 0 0 0 0 0 0 0 0 0 0 0 0 0 0 0 0 0 0 0 0 0 0 0 0 0 0 0 0 0 0 0 0 0 0 0 1 0 0 0 0 0
1 1 1 1 1 1 1 1 1 0 0 0 0 0 1 1 1 1 1 1 1 1 1 1 1 1 1 1 1 1 1 1 1 1 1 1 1 1 1 1 1 1 1 1 1 1 1 1 1 1 0 0 0 0 0
1 1 1 1 1 1 1 1 1 0 0 0 0 0 1 0 0 0 0 0 0 0 0 0 0 0 0 0 0 0 0 0 0 0 0 0 0 0 0 0 0 0 0 0 0 0 0 0 0 1 0 0 0 0 0
1 1 1 1 1 1 1 1 1 0 0 0 0 0 1 0 0 0 1 1 1 0 0 1 1 1 0 0 1 1 1 0 0 1 1 1 0 0 1 1 1 0 0 1 1 1 0 0 0 1 0 0 0 0 0
1 1 1 1 1 1 1 1 1 0 0 0 0 0 1 0 0 0 1 1 1 0 0 1 1 1 0 0 1 1 1 0 0 1 1 1 0 0 1 1 1 0 0 1 1 1 0 0 0 1 0 0 0 0 0
1 1 1 1 1 1 1 1 1 0 0 0 0 0 1 0 0 0 1 1 1 0 0 1 1 1 0 0 1 1 1 0 0 1 1 1 0 0 1 1 1 0 0 1 1 1 0 0 0 1 0 0 0 0 0
1 1 1 1 1 1 1 1 1 0 0 0 0 0 1 0 0 0 0 0 0 0 0 0 0 0 0 0 0 0 0 0 0 0 0 0 0 0 0 0 0 0 0 0 0 0 0 0 0 1 0 0 0 0 0
1 1 1 1 1 1 1 1 1 0 0 0 0 0 1 0 0 0 0 0 0 0 0 0 0 0 0 0 0 0 0 0 0 0 0 0 0 0 0 0 0 0 0 0 0 0 0 0 0 1 0 0 0 0 0
1 1 1 1 1 1 1 1 1 0 0 3 0 0 1 0 0 0 1 1 1 0 0 1 1 1 0 0 1 1 1 0 0 1 1 1 0 0 1 1 1 0 0 1 1 1 0 0 0 1 0 0 0 0 0
1 1 1 1 1 1 1 1 1 1 1 1 1 1 1 0 0 0 1 1 1 0 0 1 1 1 0 0 1 1 1 0 0 1 1 1 0 0 1 1 1 0 0 1 1 1 0 0 0 1 0 0 0 0 0
1 1 1 1 1 1 1 1 1 0 0 0 0 0 1 0 0 0 1 1 1 0 0 1 1 1 0 0 1 1 1 0 0 1 1 1 0 0 1 1 1 0 0 1 1 1 0 0 0 1 0 0 0 0 0
1 1 1 1 1 1 1 1 1 0 0 0 0 0 1 0 0 0 0 0 0 0 0 0 0 0 0 0 0 0 0 0 0 0 0 0 0 0 0 0 0 0 0 0 0 0 0 0 0 1 0 0 0 0 0
1 1 1 1 1 1 1 1 1 0 0 0 0 0 1 1 1 1 1 1 1 1 1 1 1 1 1 1 1 1 1 1 1 1 1 1 1 1 1 1 1 1 1 1 1 1 1 1 1 1 0 0 0 0 0
0 0 0 0 0 0 0 0 0 0 0 0 0 0 0 0 0 0 0 0 0 0 0 0 0 0 0 0 0 0 0 0 0 0 0 0 0 0 0 0 0 0 0 0 0 0 0 0 0 0 0 0 0 0 0