38 55
0 0 0 0 0 0 0 0 0 0 0 0 0 0 0 0 0 0 0 0 0 0 0 0 0 0 0 0 0 0 0 0 0 0 0 0 0 0 0 0 0 0 0 0 0 0 0 0 0 0 0 0 0 0 0
0 0 0 0 0 0 0 0 0 0 0 0 0 0 0 0 0 0 0 0 0 0 0 0 0 0 0 0 0 0 0 0 0 0 0 0 0 0 0 0 0 0 0 0 0 0 0 0 0 0 0 0 0 0 0
1 1 1 1 1 1 1 1 1 1 1 1 1 1 1 1 1 1 1 1 1 1 1 1 1 1 1 1 1 1 1 1 1 1 1 1 1 1 1 1 1 1 1 1 1 1 1 1 1 1 1 0 0 0 0
2 2 2 2 2 2 2 2 2 2 2 2 2 2 2 2 2 2 2 2 2 2 2 2 2 2 2 2 2 2 2 2 2 2 2 2 2 2 2 2 2 2 2 2 2 2 2 2 2 2 2 3 0 0 0
4 4 4 4 4 4 4 4 5 6 4 4 4 5 6 4 4 4 4 4 4 4 4 4 4 4 4 4 4 4 4 4 4 4 4 4 4 4 4 4 4 4 4 4 4 4 4 4 4 5 2 3 0 0 0
2 2 2 2 2 2 2 2 7 2 2 8 2 2 9 2 10 11 12 10 11 12 2 2 2 2 2 2 13 14 14 14 14 14 14 14 14 15 2 2 2 2 2 2 2 16 17 16 17 7 2 3 0 0 0
18 18 18 18 18 18 19 20 7 2 21 22 23 2 9 10 11 12 10 11 12 24 25 25 25 25 25 25 26 27 27 27 27 27 27 27 27 28 25 25 25 25 25 25 29 30 31 30 31 7 2 3 0 0 0
32 32 32 32 32 32 33 34 7 2 3 0 35 2 9 10 11 12 10 11 12 36 37 38 39 39 39 39 40 41 41 41 41 41 41 41 41 42 39 39 39 39 43 37 44 16 17 16 17 7 2 3 0 0 0
32 32 32 32 32 32 32 45 7 2 3 0 35 2 9 10 11 12 10 11 12 36 2 46 47 47 47 47 48 49 49 49 49 49 49 49 49 50 47 47 47 47 51 2 44 30 31 30 31 7 2 3 0 0 0
32 32 32 32 32 32 32 45 7 2 3 0 35 2 9 2 2 2 10 11 12 36 37 46 47 47 47 47 47 47 47 47 47 47 47 47 47 47 47 47 47 47 51 37 44 16 17 16 17 7 2 3 0 0 0
32 32 32 32 32 32 32 45 7 2 3 0 35 2 9 2 2 2 10 11 12 36 2 46 47 47 47 47 47 47 47 47 47 47 47 47 47 47 47 47 47 47 51 2 44 30 31 30 31 7 2 3 0 0 0
32 32 32 32 32 32 32 45 7 2 3 0 35 2 52 4 5 2 10 11 12 36 37 46 47 47 47 47 47 47 47 47 47 47 47 47 47 47 47 47 47 47 51 37 44 16 17 16 17 7 2 3 0 0 0
32 32 32 32 32 32 32 45 7 2 3 0 35 2 2 2 2 2 10 11 12 36 2 53 54 54 54 54 54 54 54 54 54 54 54 54 54 54 54 54 54 54 55 2 44 30 31 30 31 7 2 3 0 0 0
32 32 32 32 32 32 32 45 7 2 3 0 35 2 6 4 5 2 10 11 12 36 37 56 57 56 57 56 57 56 57 56 57 56 57 56 57 56 57 56 57 56 57 37 44 16 17 16 17 7 2 3 0 0 0
32 32 32 32 32 32 32 45 7 2 3 0 35 2 9 10 11 12 10 11 12 36 2 58 59 59 59 59 59 59 59 59 59 59 59 59 59 59 59 59 59 59 60 2 44 30 31 30 31 7 2 3 0 0 0
32 32 32 32 32 32 32 45 7 2 3 0 35 2 9 10 11 12 10 11 12 36 37 53 54 54 54 54 54 54 54 61 62 63 64 54 54 54 54 54 54 54 55 37 44 16 17 16 17 7 2 3 0 0 0
32 32 32 32 32 32 32 45 7 2 3 0 35 2 9 2 2 16 17 16 17 36 2 56 57 56 57 56 57 56 57 65 66 67 68 56 57 56 57 56 57 56 57 2 44 30 31 30 31 7 2 3 0 0 0
32 32 32 32 32 32 69 70 7 2 3 0 35 2 9 2 2 30 31 30 31 36 37 58 59 59 59 59 59 59 59 71 72 72 73 59 59 59 59 59 59 59 60 37 44 16 17 16 17 7 2 3 0 0 0
32 32 32 32 32 45 74 75 7 2 3 0 35 2 9 2 2 16 17 16 17 76 77 77 77 77 77 77 78 79 79 79 79 79 79 79 79 80 77 77 77 77 77 77 81 30 31 30 31 7 2 3 0 0 0
32 32 32 32 32 45 74 75 82 2 3 0 35 2 52 4 5 30 31 30 31 2 2 10 11 12 2 2 83 79 79 79 79 79 79 79 79 84 2 2 85 86 87 2 2 2 2 2 2 7 2 3 0 0 0
32 32 32 32 32 45 88 89 2 2 3 0 35 2 2 2 2 2 2 2 2 2 2 2 2 2 2 2 2 2 2 2 2 2 2 2 2 90 2 2 91 92 93 2 2 2 2 2 2 7 2 3 0 0 0
32 32 32 32 32 45 94 95 22 22 0 0 0 22 22 22 22 22 22 22 22 22 22 22 22 22 22 22 22 22 22 22 22 22 22 22 22 22 22 22 22 22 22 22 22 22 22 23 2 7 2 3 0 0 0
32 32 32 32 32 45 96 97 0 0 0 0 0 0 0 0 0 0 0 0 0 0 0 0 0 0 0 0 0 0 0 0 0 0 0 0 0 0 0 0 0 0 0 0 0 0 0 35 8 7 2 3 0 0 0
32 32 32 32 32 45 98 99 1 1 0 0 0 1 1 1 1 1 1 1 1 1 1 1 1 1 1 1 1 1 1 1 1 1 1 1 1 1 1 1 1 1 1 1 1 1 1 100 2 7 2 3 0 0 0
32 32 32 32 32 32 18 101 2 2 3 0 35 2 2 2 2 2 2 2 2 2 2 2 2 2 2 2 2 2 2 2 2 2 2 2 2 2 2 2 2 2 2 2 2 2 2 2 2 7 2 3 0 0 0
32 32 32 32 32 32 32 45 5 2 3 0 35 2 6 4 4 4 4 4 4 4 4 4 4 4 4 4 4 4 4 4 4 4 4 4 4 4 4 4 4 4 4 4 4 4 4 4 4 82 2 3 0 0 0
32 32 32 32 32 32 32 45 7 2 3 0 35 2 9 2 2 2 2 2 2 2 2 2 2 2 2 2 2 2 2 2 2 2 2 2 2 2 2 2 2 2 2 2 2 2 2 2 2 7 2 3 0 0 0
32 32 32 32 32 32 32 45 7 2 3 0 35 2 9 2 102 103 104 105 106 102 103 104 105 106 102 103 104 105 106 102 103 104 105 106 102 103 104 105 106 102 103 104 105 106 102 103 2 7 2 3 0 0 0
32 32 32 32 32 32 32 45 7 2 3 0 35 2 9 2 107 108 109 110 111 107 108 109 110 111 107 108 109 110 111 107 108 109 110 111 107 108 109 110 111 107 108 109 110 111 107 108 2 7 2 3 0 0 0
32 32 32 32 32 32 32 45 7 2 3 0 35 2 9 2 107 108 112 113 114 107 108 112 113 114 107 108 112 113 114 107 108 112 113 114 107 108 112 113 114 107 108 112 113 114 107 108 2 7 2 3 0 0 0
69 69 69 69 69 69 69 70 7 2 3 0 35 2 9 2 107 115 116 116 116 115 115 116 116 116 115 115 116 116 116 115 115 116 116 116 115 115 116 116 116 115 115 116 116 116 115 108 2 7 2 3 0 0 0
117 118 117 118 117 118 117 75 7 2 119 1 100 2 9 2 107 115 120 120 120 115 115 120 120 120 115 115 120 120 120 115 115 120 120 120 115 115 120 120 120 115 115 120 120 120 115 108 2 7 2 3 0 0 0
117 118 117 118 117 118 117 75 7 2 2 8 2 2 9 2 107 108 104 105 106 107 108 104 105 106 107 108 104 105 106 107 108 104 105 106 107 108 104 105 106 107 108 104 105 106 107 108 2 7 2 3 0 0 0
117 118 117 118 117 118 117 75 7 6 4 4 4 5 9 2 107 108 109 110 111 107 108 109 110 111 107 108 109 110 111 107 108 109 110 111 107 108 109 110 111 107 108 109 110 111 107 108 2 7 2 3 0 0 0
121 121 121 121 121 121 121 89 7 2 2 2 2 2 9 2 122 123 112 113 114 122 123 112 113 114 122 123 112 113 114 122 123 112 113 114 122 123 112 113 114 122 123 112 113 114 122 123 2 7 2 3 0 0 0
2 2 2 2 2 2 2 2 7 2 2 2 2 2 9 2 2 2 2 2 2 2 2 2 2 2 2 2 2 2 2 2 2 2 2 2 2 2 2 2 2 2 2 2 2 2 2 2 2 7 2 3 0 0 0
4 4 4 4 4 4 4 4 82 2 2 2 2 2 6 4 4 4 4 4 4 4 4 4 4 4 4 4 4 4 4 4 4 4 4 4 4 4 4 4 4 4 4 4 4 4 4 4 4 82 2 3 0 0 0
2 2 2 2 2 2 2 2 2 2 2 2 2 2 2 2 2 2 2 2 2 2 2 2 2 2 2 2 2 2 2 2 2 2 2 2 2 2 2 2 2 2 2 2 2 2 2 2 2 2 2 3 0 0 0
END_MAP
0 0 0 0 0 0 0 0 0 0 0 0 0 0 0 0 0 0 0 0 0 0 0 0 0 0 0 0 0 0 0 0 0 0 0 0 0 0 0 0 0 0 0 0 0 0 0 0 0 0 0 0 0 0 0
0 0 0 0 0 0 0 0 0 0 0 0 0 0 0 0 0 0 0 0 0 0 0 0 0 0 0 0 0 0 0 0 0 0 0 0 0 0 0 0 0 0 0 0 0 0 0 0 0 0 0 0 0 0 0
0 0 0 0 0 0 0 0 0 0 0 0 0 0 0 0 0 0 0 0 0 0 0 0 0 0 0 0 0 0 0 0 0 0 0 0 0 0 0 0 0 0 0 0 0 0 0 0 0 0 0 0 0 0 0
0 0 0 0 0 0 0 0 0 0 0 0 0 0 0 0 0 0 0 0 0 0 0 0 0 0 0 0 0 0 0 0 0 0 0 0 0 0 0 0 0 0 0 0 0 0 0 0 0 0 0 0 0 0 0
1 1 1 1 1 1 1 1 1 1 1 1 1 1 1 1 1 1 1 1 1 1 1 1 1 1 1 1 1 1 1 1 1 1 1 1 1 1 1 1 1 1 1 1 1 1 1 1 1 1 0 0 0 0 0
1 1 1 1 1 1 1 1 1 0 0 3 0 0 1 1 1 1 1 1 1 1 1 1 1 1 1 1 1 1 1 1 1 1 1 1 1 1 1 1 1 1 1 1 1 1 1 1 1 1 0 0 0 0 0
1 1 1 1 1 1 1 1 1 0 0 0 0 0 1 1 1 1 1 1 1 1 0 0 0 0 0 0 0 1 1 1 1 1 1 1 1 0 0 0 0 0 0 0 1 1 1 1 1 1 0 0 0 0 0
1 1 1 1 1 1 1 1 1 0 0 0 0 0 1 1 1 1 1 1 1 1 0 1 1 1 1 1 1 1 1 1 1 1 1 1 1 1 1 1 1 1 1 0 1 1 1 1 1 1 0 0 0 0 0
1 1 1 1 1 1 1 1 1 0 0 0 0 0 1 1 1 1 1 1 1 1 0 1 1 1 1 1 1 1 1 1 1 1 1 1 1 1 1 1 1 1 1 0 1 1 1 1 1 1 0 0 0 0 0
1 1 1 1 1 1 1 1 1 0 0 0 0 0 1 0 0 0 1 1 1 1 0 1 1 1 1 1 1 1 1 1 1 1 1 1 1 1 1 1 1 1 1 0 1 1 1 1 1 1 0 0 0 0 0
1 1 1 1 1 1 1 1 1 0 0 0 0 0 1 0 0 0 1 1 1 1 0 1 1 1 1 1 1 1 1 1 1 1 1 1 1 1 1 1 1 1 1 0 1 1 1 1 1 1 0 0 0 0 0
1 1 1 1 1 1 1 1 1 0 0 0 0 0 1 1 1 0 1 1 1 1 0 1 1 1 1 1 1 1 1 1 1 1 1 1 1 1 1 1 1 1 1 0 1 1 1 1 1 1 0 0 0 0 0
1 1 1 1 1 1 1 1 1 0 0 0 0 0 0 0 0 0 1 1 1 1 0 1 1 1 1 1 1 1 1 1 1 1 1 1 1 1 1 1 1 1 1 0 1 1 1 1 1 1 0 0 0 0 0
1 1 1 1 1 1 1 1 1 0 0 0 0 0 1 1 1 0 1 1 1 1 0 1 1 1 1 1 1 1 1 1 1 1 1 1 1 1 1 1 1 1 1 0 1 1 1 1 1 1 0 0 0 0 0
1 1 1 1 1 1 1 1 1 0 0 0 0 0 1 1 1 1 1 1 1 1 0 1 1 1 1 1 1 1 1 1 1 1 1 1 1 1 1 1 1 1 1 0 1 1 1 1 1 1 0 0 0 0 0
1 1 1 1 1 1 1 1 1 0 0 0 0 0 1 1 1 1 1 1 1 1 0 1 1 1 1 1 1 1 1 1 1 1 1 1 1 1 1 1 1 1 1 0 1 1 1 1 1 1 0 0 0 0 0
1 1 1 1 1 1 1 1 1 0 0 0 0 0 1 0 0 1 1 1 1 1 0 1 1 1 1 1 1 1 1 1 2 2 1 1 1 1 1 1 1 1 1 0 1 1 1 1 1 1 0 0 0 0 0
1 1 1 1 1 1 1 1 1 0 0 0 0 0 1 0 0 1 1 1 1 1 0 1 1 1 1 1 1 1 1 1 0 0 1 1 1 1 1 1 1 1 1 0 1 1 1 1 1 1 0 0 0 0 0
1 1 1 1 1 1 1 1 1 0 0 0 0 0 1 0 0 1 1 1 1 1 1 1 1 1 1 1 1 0 0 0 0 0 0 0 0 1 1 1 1 1 1 1 1 1 1 1 1 1 0 0 0 0 0
1 1 1 1 1 1 1 1 1 0 0 0 0 0 1 1 1 1 1 1 1 0 0 1 1 1 0 0 1 0 0 0 0 0 0 0 0 1 0 0 3 1 3 0 0 0 0 0 0 1 0 0 0 0 0
1 1 1 1 1 1 1 1 0 0 0 0 0 0 0 0 0 0 0 0 0 0 0 0 0 0 0 0 0 0 0 0 0 0 0 0 0 3 0 0 3 3 3 0 0 0 0 0 0 1 0 0 0 0 0
1 1 1 1 1 1 2 0 0 0 0 0 0 0 0 0 0 0 0 0 0 0 0 0 0 0 0 0 0 0 0 0 0 0 0 0 0 0 0 0 0 0 0 0 0 0 0 0 0 1 0 0 0 0 0
1 1 1 1 1 1 2 0 0 0 0 0 0 0 0 0 0 0 0 0 0 0 0 0 0 0 0 0 0 0 0 0 0 0 0 0 0 0 0 0 0 0 0 0 0 0 0 0 3 1 0 0 0 0 0
1 1 1 1 1 1 2 0 0 0 0 0 0 0 0 0 0 0 0 0 0 0 0 0 0 0 0 0 0 0 0 0 0 0 0 0 0 0 0 0 0 0 0 0 0 0 0 0 0 1 0 0 0 0 0
1 1 1 1 1 1 1 1 0 0 0 0 0 0 0 0 0 0 0 0 0 0 0 0 0 0 0 0 0 0 0 0 0 0 0 0 0 0 0 0 0 0 0 0 0 0 0 0 0 1 0 0 0 0 0
1 1 1 1 1 1 1 1 1 0 0 0 0 0 1 1 1 1 1 1 1 1 1 1 1 1 1 1 1 1 1 1 1 1 1 1 1 1 1 1 1 1 1 1 1 1 1 1 1 1 0 0 0 0 0
1 1 1 1 1 1 1 1 1 0 0 0 0 0 1 0 0 0 0 0 0 0 0 0 0 0 0 0 0 0 0 0 0 0 0 0 0 0 0 0 0 0 0 0 0 0 0 0 0 1 0 0 0 0 0
1 1 1 1 1 1 1 1 1 0 0 0 0 0 1 0 0 0 1 1 1 0 0 1 1 1 0 0 1 1 1 0 0 1 1 1 0 0 1 1 1 0 0 1 1 1 0 0 0 1 0 0 0 0 0
1 1 1 1 1 1 1 1 1 0 0 0 0 0 1 0 0 0 1 1 1 0 0 1 1 1 0 0 1 1 1 0 0 1 1 1 0 0 1 1 1 0 0 1 1 1 0 0 0 1 0 0 0 0 0
1 1 1 1 1 1 1 1 1 0 0 0 0 0 1 0 0 0 1 1 1 0 0 1 1 1 0 0 1 1 1 0 0 1 1 1 0 0 1 1 1 0 0 1 1 1 0 0 0 1 0 0 0 0 0
1 1 1 1 1 1 1 1 1 0 0 0 0 0 1 0 0 0 0 0 0 0 0 0 0 0 0 0 0 0 0 0 0 0 0 0 0 0 0 0 0 0 0 0 0 0 0 0 0 1 0 0 0 0 0
1 1 1 1 1 1 1 1 1 0 0 0 0 0 1 0 0 0 0 0 0 0 0 0 0 0 0 0 0 0 0 0 0 0 0 0 0 0 0 0 0 0 0 0 0 0 0 0 0 1 0 0 0 0 0
1 1 1 1 1 1 1 1 1 0 0 3 0 0 1 0 0 0 1 1 1 0 0 1 1 1 0 0 1 1 1 0 0 1 1 1 0 0 1 1 1 0 0 1 1 1 0 0 0 1 0 0 0 0 0
1 1 1 1 1 1 1 1 1 1 1 1 1 1 1 0 0 0 1 1 1 0 0 1 1 1 0 0 1 1 1 0 0 1 1 1 0 0 1 1 1 0 0 1 1 1 0 0 0 1 0 0 0 0 0
1 1 1 1 1 1 1 1 1 0 0 0 0 0 1 0 0 0 1 1 1 0 0 1 1 1 0 0 1 1 1 0 0 1 1 1 0 0 1 1 1 0 0 1 1 1 0 0 0 1 0 0 0 0 0
1 1 1 1 1 1 1 1 1 0 0 0 0 0 1 0 0 0 0 0 0 0 0 0 0 0 0 0 0 0 0 0 0 0 0 0 0 0 0 0 0 0 0 0 0 0 0 0 0 1 0 0 0 0 0
1 1 1 1 1 1 1 1 1 0 0 0 0 0 1 1 1 1 1 1 1 1 1 1 1 1 1 1 1 1 1 1 1 1 1 1 1 1 1 1 1 1 1 1 1 1 1 1 1 1 0 0 0 0 0
0 0 0 0 0 0 0 0 0 0 0 0 0 0 0 0 0 0 0 0 0 0 0 0 0 0 0 0 0 0 0 0 0 0 0 0 0 0 0 0 0 0 0 0 0 0 0 0 0 0 0 0 0 0 0